11111111111
10210100001
10121202011
12120201211
11212200201
10021211101
12201121011
11120211011
10211011121
12010110201
11100102221
11251020111
10020010211
11111111111
